0000000000000000
0000000000000000
0000000000000000
0000000000000000
0000000000000000
0000000000000000
0000000000000000
0011000000000000
0001000000000000
1101000000000000
4001000000000002
1111111111111111