1111111111111111
4001111111111102
1001111111111101
1100011111110001
1100001111110011
1110000000000111
1110001100011111
1110000000111111
1111111111111111
1111111111111111
1111111111111111
1111111111111111